111111111111111
1P00000000000C1
100000000000001
100100000000001
100000000000001
1010000C0000001
100000000000001
100000000000011
1000000000000E1
111111111111111