1111111111111111111111111
1P00000000000000000000001
1C1C1C1C1C1C1C1C1C1C1C1C1
1000000000000000000000001
1C1C1C1C1C1C1C1C1C1C1C1C1
1000000000000000000000001
1C1C1C1C1C1C1C1C1C1C1C1C1
1000000000000000000000001
1C1C1C1C1C1C1C1C1C1C1C1C1
1000000000000000000000001
1C1C1C1C1C1C1C1C1C1C1C1C1
1000000000000000000000001
1C1C1C1C1C1C1C1C1C1C1C1C1
1000000000000000000000001
1C1C1C1C1C1C1C1C1C1C1C1C1
1000000000000000000000001
1C1C1C1C1C1C1C1C1C1C1C111
1001110000000000000000EC1
1111111111111111111111111