111111
1PCCC1
1CCC01
1CCC01
1ECC01
111111