11111111111111111111
1E000000000000000001
1000000000C000000001
10001111111111111101
10000000010001000001
1P000000011100000001
11111111111111111111